1
10
10
0:0:0:0:0:0:0:0:0:0
0:0:0:1:0:0:0:0:0:0
0:0:1:21:1:0:0:0:0:0
0:0:0:1:0:0:0:0:0:0
0:0:0:0:0:0:1:0:0:0
0:0:0:0:0:1:21:1:0:0
0:0:0:0:0:0:1:0:0:0
0:0:1:0:0:0:0:1:0:0
0:1:21:1:0:0:1:21:1:0
0:0:1:0:0:0:0:1:0:0