4
7
12
1:1:1:1:1:1:1
1:2:6:6:6:3:1
1:7:8:8:8:7:1
1:7:8:8:8:7:1
1:7:8:8:8:7:1
1:7:8:8:8:10:1
1:7:8:8:8:8:1
1:7:8:8:8:8:1
1:7:8:8:8:9:1
1:7:8:8:8:7:1
1:4:6:6:6:5:1
1:1:1:1:1:1:1