3
12
12
1:1:1:1:1:1:1:1:1:1:1:1
1:2:6:6:6:6:6:6:6:6:3:1
1:7:8:8:8:7:8:8:8:23:7:1
1:7:8:8:8:7:8:8:8:8:7:1
1:7:8:8:8:7:8:8:8:8:7:1
1:7:8:8:8:10:8:11:6:6:7:1
1:7:8:8:8:8:8:8:8:8:7:1
1:7:8:8:8:8:8:8:8:8:7:1
1:7:8:8:8:8:8:8:8:8:7:1
1:7:8:8:8:8:8:8:8:8:7:1
1:4:6:6:12:8:8:11:6:6:5:1
1:1:1:1:1:1:1:1:1:1:1:1