2
12
12
1:1:1:1:12:8:8:11:1:1:1:1
1:2:6:6:6:6:6:6:6:6:3:1
1:7:8:8:8:8:8:8:8:8:7:1
1:10:8:8:8:8:8:8:8:8:7:10
1:8:8:8:8:8:8:8:8:8:8:1
1:8:8:8:8:8:8:8:8:8:8:1
1:9:8:8:8:8:8:8:8:8:7:9
1:7:8:8:8:8:8:8:8:8:7:1
1:7:8:8:8:8:8:8:8:8:7:1
1:7:8:8:8:8:8:8:8:8:7:1
1:4:6:6:12:8:8:11:6:6:5:1
1:1:1:1:1:1:1:1:1:1:1:1