5
7
7
1:1:1:1:1:1:1
1:2:6:6:6:3:1
1:7:23:8:23:7:1
1:7:8:8:8:7:1
1:7:8:8:8:7:1
1:4:12:8:11:5:1
1:1:1:1:1:1:1